1111111
1P11111
1C001E1
1011111
10C0111
1111111
