111111111111111111111111111111
10000C00011C000C00011000000001
111001110110011111111000000001
1C001000010C000C00011111100001
10P001011111111C1000000000C001
100C10000000000C10011000111101
111101011111101110011C00100001
100001010000101000C1100E000001
1C0000011110101111111111111001
111011111111111111111C00000001
1000000000000C0000000000000001
111111111111111111111111111111