11111111111111111111
1P000C00011C000C00E1
11100111011001111111
1C001000010C000C0001
100001011111111C1001
100C10000000000C1001
11110101111110111001
100001010000101000C1
1C000001111010111111
11111111111111111111