1111111
1P00001
100C001
1111001
1C001E1
1101101
1000001
1C00001
1111111